2 4 4000 3460 7430 7420 
2 7 4316 7413 76 1639 7511 1137 2706 
3 7 7636 7645 4276 3024 461 4958 7653 
2 10 7636 3690 863 7599 1393 7575 1975 7563 7556 2706 
1 2 4316 4000 
2 9 4316 2582 7382 1892 7337 7323 4446 654 5254 
1 13 7054 1109 7026 7046 1114 7034 2911 7016 2756 7039 7038 1037 2051 
2 6 4842 7127 1548 7169 3981 7219 
2 9 3104 7048 5026 7077 2630 7128 2837 705 3815 
5 4 7184 5435 1106 7182 
4 7 7184 5432 7164 7150 7132 7114 7100 
3 13 7410 4209 7377 4634 2994 7319 2147 4326 1887 4839 2337 6402 7184 
3 12 7410 7415 4722 7417 7424 5145 1546 2861 7396 5037 4752 7380 
3 9 7222 7237 2624 4599 7287 2557 4398 4038 880 
3 11 2051 5118 3104 3795 305 4842 7102 1669 7101 3575 3442 
1 3 6985 1204 4778 
4 8 3811 961 6992 4881 7025 7036 4386 7045 
4 12 4889 3847 1726 7080 1832 5289 607 1759 4747 1268 7104 7114 
4 3 4889 262 7045 
2 3 7380 1789 2721 
1 3 3197 6900 673 
1 10 6900 3581 4272 871 1729 2323 6920 2154 2698 6923 
5 2 3811 7478 
4 11 3811 1372 6929 3785 2031 2697 6889 6869 2063 3924 6809 
4 3 2063 6867 4049 
3 6 6809 2727 4321 3430 6742 4782 
2 7 6809 4016 1478 5348 4126 194 3512 
1 11 4397 6342 2173 6295 6268 4676 1800 6178 1283 2686 1572 
1 11 1800 6173 314 120 3237 4910 5989 3510 3281 1102 2074 
1 10 1898 1865 4705 5992 3376 1603 6085 2601 4694 1572 
2 6 2074 4708 2106 4804 3642 3846 
2 5 2074 598 2641 4876 190 
1 6 4650 2344 3727 2010 5803 5778 
2 9 1898 3970 217 1450 4351 1412 4906 3464 3293 
2 5 3293 3365 1643 6045 6081 
2 5 3293 3850 384 5843 5868 
2 7 5868 3739 5822 5771 1188 4060 3018 
1 9 3018 5639 3708 4467 2269 1016 828 4859 5447 
1 11 5868 2985 3593 5933 513 395 3703 2858 3154 3561 4030 
1 8 6044 2282 2025 5159 6002 2631 3448 1643 
1 5 1296 5551 4973 739 5521 
2 24 252 3401 7754 5836 2492 5820 2145 5815 5825 3601 5855 1987 3664 2590 4759 5865 5867 5879 1905 5869 5884 3099 5897 5885 
1 4 5836 3054 5097 959 
5 12 5658 1072 1864 2486 5616 5149 5622 4500 431 3950 5027 1946 
4 4 7804 5693 5658 4452 
1 5 1946 3368 5662 2332 1732 
1 3 1732 5624 5627 
1 9 6262 6129 6267 5354 841 5096 432 1468 4614 
3 4 4614 80 6399 2279 
2 11 7219 3759 1911 761 1024 7321 2615 2679 844 4957 1476 
1 4 761 7316 2741 7332 
1 10 3442 7108 7096 7081 4750 735 3663 4945 673 3197 
3 9 3197 1461 5331 4778 5320 965 4749 7146 2051 
1 5 3302 3354 5166 3187 5417 
1 3 6795 6817 1773 
1 11 6809 867 2749 724 2453 6833 6812 6787 3395 6773 4234 
1 8 961 6942 6958 2113 829 3770 3638 1773 
1 6 829 5209 684 1179 2233 3338 
1 8 4016 6828 5014 2847 4949 3488 6848 6863 
2 3 7184 6402 2550 
3 4 4326 2147 7266 3506 
3 3 3506 456 4946 
3 4 4946 3952 7267 4789 
3 9 7380 1858 7344 3830 2189 7254 1235 4084 7222 
2 4 7222 851 3570 1405 
1 4 1405 1881 4055 7067 
3 4 4789 1929 7279 7254 
1 6 7085 2088 7134 874 4954 60 
1 5 7658 2616 5153 4836 5156 
1 6 2262 254 5085 4149 3669 2183 
1 7 2262 6148 4306 1565 4831 3277 6073 
2 8 4354 5844 4615 5756 5689 208 5686 4150 
1 19 3585 5580 3528 1930 5552 5568 2060 4496 910 5540 4907 5565 5570 754 5583 5605 2295 5637 5658 
1 8 6795 2975 3595 3060 6720 6695 6664 3302 
1 4 4234 6771 2578 3595 
1 6 7747 7730 3928 7710 5010 7697 
1 3 6720 2719 3416 
1 5 6795 6803 5296 3501 6763 
1 8 1372 6908 4408 4172 2891 4780 6785 4234 
1 3 7036 7015 7028 
5 2 4782 770 
1 3 5252 4355 4326 
1 5 7380 635 5321 5250 7436 
1 2 635 1541 
1 2 7237 887 
1 3 2624 7230 585 
1 3 7222 7213 2090 
1 2 1881 345 
2 4 4789 7257 562 554 
1 2 554 7185 
1 3 562 2229 7154 
1 4 4946 166 7244 554 
1 3 7415 7435 4722 
1 5 4634 3560 7320 2472 5252 
3 2 5435 3757 
1 4 3430 6766 6782 1478 
1 9 6262 2288 4391 3635 6064 6088 5951 3132 5836 
2 3 1669 507 4050 
2 5 7219 3927 3183 7268 7261 
1 2 1204 4537 
1 4 2837 1260 899 7219 
1 4 1656 640 3496 366 
1 4 7332 7330 2768 652 
1 3 1476 1877 7448 
1 3 1877 4588 7493 
1 4 1476 287 7456 7474 
1 3 4509 1770 7389 
1 8 3238 2903 7008 1854 3809 1622 4034 7274 
1 4 7231 1449 1247 1984 
2 8 3815 1656 1792 414 7273 4156 7289 3755 
1 14 7274 291 7231 26 7247 7265 7286 7296 7281 2443 3755 4742 7331 844 
2 2 3847 3653 
1 3 7396 3032 4462 
1 2 1892 4769 
1 2 2652 5254 
1 3 462 7322 7337 
1 3 7157 1116 2648 
1 4 7176 7189 1511 7201 
1 6 6081 2606 198 4730 6246 6277 
1 2 198 630 
1 2 3237 2656 
1 4 4676 1110 4827 3071 
1 4 434 825 306 5934 
1 4 2411 3546 6626 3302 
2 3 285 5823 3229 
1 2 3229 1987 
1 2 285 5825 
1 9 5521 3821 5513 486 5467 3045 5058 2293 3289 
1 2 4354 5869 
1 3 4150 5643 3810 
1 4 1856 5646 2965 3446 
1 10 6344 6346 2515 4514 889 2830 4635 4143 5286 2201 
1 8 5156 2999 2637 3882 7572 743 2908 1543 
1 4 2908 7557 2638 1523 
1 4 7557 7562 2883 1122 
1 10 1543 7554 670 2351 342 3311 7545 7540 2873 2706 
2 6 7636 1256 2265 771 496 4974 
1 9 4974 4518 7662 3078 7656 7661 3744 3502 7668 
1 5 4974 3462 7640 7635 1374 
1 18 1374 1626 7627 4571 7609 2207 2807 3881 7566 4923 3526 7531 5244 2885 4322 3040 3559 7466 
1 7 7466 3314 1438 7455 5087 7434 7420 
1 8 3928 1594 7727 3583 1970 674 3766 25 
1 4 7747 4944 7738 2920 
1 7 7697 105 4882 7682 5248 3857 7668 
1 2 7028 3653 
1 3 7114 4825 5261 
1 5 7436 4235 7470 967 2495 
1 4 880 1391 7395 577 
1 2 1391 4038 
1 5 2453 4870 1491 6882 4172 
1 7 6044 6040 3869 6070 6059 3978 6013 
1 3 4030 4847 5105 
1 3 5447 3490 693 
1 4 5447 2217 2570 1236 
1 6 5934 2954 5220 5805 2156 4331 
1 4 2656 2754 6036 4997 
1 7 5024 4921 5925 3563 5974 4295 4997 
1 9 5934 2605 4362 2689 6006 4244 4855 6017 4997 
1 3 209 1601 2412 
1 5 2412 1369 738 3334 5659 
1 4 5778 5758 2263 209 
2 8 190 4297 2805 495 360 1625 5705 209 
1 8 1122 7569 494 7543 5305 7508 3943 3645 
1 9 5156 441 2527 1424 7641 2796 1287 3691 1621 
1 9 342 4356 2432 2310 7601 7616 4230 245 4958 
1 10 6446 1257 6475 2 2972 5052 73 1189 6490 1746 
1 2 2 4056 
1 4 1257 6489 4157 148 
1 2 1987 5931 
1 8 5686 4551 2704 4807 3292 5755 2983 2604 
1 2 5885 5942 
2 7 1898 3398 5066 3290 4650 5896 3846 
1 7 2601 807 2211 6139 1763 4524 1171 
1 7 1171 6142 2669 6168 4528 6195 630 
1 9 3071 539 1377 1130 3226 1044 6503 6513 92 
1 11 6354 1341 6344 3345 6278 6259 504 3284 4888 2593 2262 
1 3 2262 6185 929 
1 6 5254 4653 7206 1577 7157 7168 
2 3 7176 7160 7168 
1 5 7168 4100 2724 7108 7096 
1 6 7168 3969 7126 7107 7094 4633 
1 3 4633 4023 4757 
1 3 3289 902 5445 
1 12 1296 5276 2878 5532 1745 4915 5503 5488 4864 5480 4850 5445 
1 10 2156 5760 2747 5701 1649 1651 5599 3550 5589 5226 
2 7 3512 3833 6768 3241 6722 7 3632 
1 7 1720 6376 2573 1707 4728 6500 1896 
2 10 3632 475 6673 6649 2148 906 6609 4600 1944 6584 
1 3 4590 465 252 
1 13 4590 5960 392 848 2955 1586 6156 3562 6206 344 6266 6287 6262 
1 5 5225 5969 2589 3558 6266 
1 5 6202 2618 6171 6141 434 
1 8 4423 644 3015 308 6202 2114 3073 5225 
1 6 6491 6439 241 6371 545 5225 
1 9 2573 4282 5062 2760 6393 1920 749 6343 545 
1 2 1707 3469 
1 4 1336 6583 1580 3072 
2 6 1336 919 1629 3225 1896 6584 
1 3 2477 478 3234 
2 6 1336 3483 2477 156 1048 2148 
1 3 3241 2517 3438 
1 2 2517 4909 
2 7 6845 6827 6801 606 6752 3796 6711 
1 4 6694 2141 1241 2244 
1 13 6694 6643 1034 3723 952 6536 2671 5091 3343 6459 5205 416 1720 
1 7 2671 4392 2314 3548 1186 1334 4600 
1 7 2314 4406 6612 6640 187 5323 6711 
2 4 6784 3447 6718 6694 
1 5 6711 2526 4164 820 3632 
1 6 2244 6704 1131 2085 4293 606 
1 8 6921 2311 920 277 3514 3163 6946 6955 
1 2 277 6962 
2 6 6863 1232 4628 2728 2447 6955 
2 3 4628 24 5377 
1 7 4670 6910 1550 6966 3095 318 7013 
2 5 7011 3189 3441 3196 6906 
1 5 3441 6973 4947 5335 4032 
1 5 7011 3050 7069 466 4309 
1 2 3050 5380 
1 10 5018 7394 4913 7369 4103 1305 7306 1519 4028 3209 
1 4 4028 7262 2587 7360 
1 8 7360 4262 802 4548 5003 943 2877 5018 
1 6 7360 5382 7361 623 7370 7401 
1 2 5382 4822 
1 8 1780 2390 4348 3166 7092 1104 7091 4619 
1 2 4348 7084 
2 7 6955 6939 40 1290 1224 4619 1628 
2 7 1628 1749 1403 5356 1194 7013 4032 
1 2 1403 7136 
1 5 7401 1819 3276 7313 298 
1 3 1628 398 4021 
1 7 7136 1840 2049 7235 3728 5263 7313 
1 4 7235 7224 3709 691 
1 2 7224 3124 
1 4 3276 1673 3124 2161 
1 3 6141 2210 4083 
2 8 5377 927 2327 3920 6821 5365 3162 3512 
3 6 6845 6875 4670 4340 1135 5377 
3 9 843 6917 6878 6906 2122 6861 3013 6858 6845 
1 8 6491 6485 6479 1599 492 2222 6514 1629 
1 2 4728 6499 
1 2 5365 6848 
3 5 843 979 6832 1827 6784 
1 4 1827 6835 6857 6878 
1 6 820 971 3010 3987 2355 2327 
1 5 92 6548 3959 2934 1684 
1 9 1684 6645 3379 6589 6582 4440 4693 4976 6600 
1 4 4976 8 4820 1862 
1 6 1130 3341 1469 4058 6389 3070 
1 5 434 6111 4478 1251 449 
2 9 4688 4709 6516 3131 6487 3303 3261 6552 3667 
1 14 3667 6586 113 6550 1689 4197 6508 4791 611 6449 6426 3092 4638 1912 
1 13 2074 5024 605 1250 966 3905 4812 3643 3259 2957 3011 4846 5220 
1 7 5220 4578 218 3911 274 3682 252 
1 10 5372 2646 4544 94 4811 1392 6241 4924 1157 6237 
1 7 5372 189 6189 255 5193 785 627 
2 9 627 509 6027 6009 5986 5949 3069 712 5849 
1 6 5849 5957 5973 1417 5964 1041 
1 8 5809 5724 5835 4051 714 3417 1602 1041 
1 6 5658 3207 3167 5720 2067 5809 
2 6 5860 2479 5042 4482 5883 5885 
2 7 1912 4112 6352 1963 3954 6285 6260 
3 10 6260 810 6229 480 2947 5176 6162 864 1822 2808 
2 19 950 6200 6151 6120 6094 6033 4344 6026 4835 6123 5985 1281 4338 5984 4428 5961 5918 3831 5860 
1 7 1822 732 3824 6248 6286 1015 6355 
1 5 3824 6272 4805 5259 2065 
1 3 1912 1125 5259 
1 9 480 4109 6224 1129 4979 4489 523 2115 1912 
1 3 6355 1380 6417 
1 5 950 6265 762 5314 1380 
1 5 6417 1293 6443 6455 385 
1 3 4251 3404 6586 
1 11 221 319 2117 6540 3536 6592 6606 1589 2299 6674 2296 
1 4 5061 4250 5976 6009 
2 7 5658 334 4439 4508 3393 248 125 
1 10 5521 1834 5515 5522 5506 4283 2415 2997 5131 4729 
1 4 2686 6228 1895 6231 
1 4 2686 5080 4089 4400 
1 4 125 2281 5739 4753 
1 5 125 4377 5721 5716 5699 
1 10 5699 5794 3878 5791 5059 5845 5838 2461 1258 5061 
1 8 4753 5774 4937 642 3429 5881 5909 1041 
1 4 125 995 2682 5622 
1 6 6073 6047 6024 5998 2387 5942 
1 6 2183 550 5174 1107 2190 5879 
1 2 7096 2724 
1 5 4811 1698 6116 6100 4793 
1 8 4793 6067 830 2341 6021 6030 5594 1662 
1 4 5372 4437 4181 5594 
1 7 1662 3694 6001 2082 5912 2532 709 
1 6 709 742 3774 3890 3119 5061 
1 4 709 5817 3584 5776 
1 8 709 595 5765 1846 5694 2525 5638 5627 
1 8 1506 6043 2058 357 1088 2081 1979 1273 
2 18 1979 1138 1004 5853 3273 10999 3628 4796 5850 5876 3681 5878 5899 7806 1727 894 5990 830 
1 9 709 964 5175 1428 2016 784 5913 3419 1727 
1 7 221 2922 2845 4903 1641 1077 6417 
2 11 4688 6631 302 6662 2666 1234 1376 5422 6744 1345 5094 
2 9 4688 4952 6560 3444 6495 4005 284 4499 6367 
1 4 1376 6779 2516 6753 
1 8 3667 2494 4330 876 338 2296 2038 6724 
1 12 6923 1074 6792 2988 1470 387 6813 10777 2437 4905 2300 6724 
1 11 6724 2733 909 2820 5366 4685 240 6725 2789 6758 4046 
1 2 6725 6736 
1 20 1074 1473 2061 2884 6913 6799 1966 978 3665 6901 3718 4367 2380 4636 6907 6892 5451 6911 3412 5093 
1 15 7274 7269 2454 4509 3828 7353 3086 7402 7384 2574 7386 7368 3780 7406 1476 
1 11 1984 7124 2936 4220 7029 4731 7010 2917 6974 2931 5093 
2 10 5094 238 6733 6726 5184 2745 6723 5324 2503 6724 
1 10 5094 1703 3626 2362 4052 6826 6849 6820 6783 2437 
1 5 2362 5107 6747 5326 2503 
1 5 5451 1199 147 686 5422 
1 5 2362 6819 908 5230 6901 
1 10 6367 5341 6276 16 3299 6245 936 6163 6113 1477 
1 4 445 5168 6182 936 
1 14 3444 6528 6512 2684 4231 20 740 3768 6497 4621 5082 832 9361 945 
1 9 6753 4140 4713 707 6653 3358 667 3487 20 
1 5 4231 3218 6478 15 6414 
2 11 6367 6477 4785 1636 6414 4064 4373 586 518 945 1217 
2 26 1506 1477 4480 3671 3764 5363 1512 3605 4162 10431 3424 8519 8779 10710 11129 11136 10366 11159 9616 11186 11197 11204 8688 11218 11234 1217 
1 13 10710 9107 11115 10848 455 5526 4880 2765 2092 436 12068 6579 586 
1 10 9361 2195 8415 9354 10355 7867 11268 8233 10466 7899 
1 12 147 4253 3406 4122 2214 1139 1786 3280 7872 10579 8824 10767 
1 15 8824 10489 10329 7027 8528 11368 8479 11336 8409 10703 11308 10193 11280 9401 8415 
1 17 8810 10077 8395 9179 10606 9117 11411 9592 9526 8697 11355 8032 9326 11312 8314 9413 8233 
1 14 10767 10112 1161 9022 719 11527 8365 11499 8810 9174 8997 10151 9191 7903 
1 5 7123 2658 7181 7162 26 
1 5 5094 1143 1771 1056 147 
1 5 4793 2350 5941 831 6125 
1 9 1296 4228 1459 5631 151 4291 5734 5761 4331 
1 12 739 3378 5553 3679 246 3585 5596 1851 4935 2283 1836 285 
1 5 1189 2513 2628 955 2202 
1 12 2202 1178 3014 6233 1484 6188 6145 2969 4690 4066 2711 5931 
1 6 73 2030 3549 4851 5301 6626 
1 4 5417 6568 4082 4056 
1 9 11186 11200 9156 9213 9516 10073 11219 11226 8197 
1 11 10710 11107 7844 8007 8757 8882 11092 9140 8847 10523 10463 
1 4 10463 11059 9422 7841 
1 5 8779 11090 10030 8649 7977 
1 4 7977 8063 11026 11014 
1 12 3238 4441 3245 1067 7175 790 4817 2602 7217 4241 4076 376 
3 18 8179 10383 11821 9363 9050 9077 8243 8632 11839 8794 11827 9944 8109 7866 9129 8200 9353 10286 
1 11 10383 8585 9331 9837 8911 10145 8750 9795 10160 9116 9187 
1 7 7658 7654 7646 7652 263 7648 7653 
1 9 3153 7704 826 7698 1064 5253 1971 7667 7653 
1 16 3645 7532 7548 5271 4219 7571 3634 4535 10791 91 136 5022 1779 5 22 3475 
1 6 3475 2138 7756 11 7983 10286 
1 6 7866 10497 8345 11799 11791 2138 
2 8 10286 9169 206 10031 7780 10265 9812 9062 
1 4 9062 1001 9993 11680 
1 6 9062 1270 10161 10191 9367 11624 
1 8 10265 50 8816 5241 3686 10798 9518 10373 
1 14 10286 10167 10809 8596 10373 10790 8561 2368 27 7357 7408 2773 4121 2528 
1 8 2773 3263 4366 1600 7276 7243 7226 4817 
1 8 376 818 11612 1837 7541 4195 1370 10161 
1 12 376 2152 7153 2822 2584 1906 8127 10245 8114 8500 808 9022 
1 4 1906 7044 4434 2405 
1 7 2405 4597 990 7000 6987 1710 5093 
1 8 2405 5345 2963 1787 6928 6916 6881 3280 
1 17 7903 8149 10123 11557 10753 10748 8648 9453 7910 8730 11644 8145 11670 8062 11701 11710 9187 
1 11 3645 181 7499 7485 3123 1677 7398 7372 7351 777 2528 
1 11 5377 6839 6847 4173 193 6845 2475 5195 6843 3564 6857 
1 2 927 6839 
