2 4 4000 3460 7430 7420 
2 7 4316 7413 76 1639 7511 1137 2706 
3 5 7636 7645 4276 3024 461 
2 10 7636 3690 863 7599 1393 7575 1975 7563 7556 2706 
1 2 4316 4000 
2 9 4316 2582 7382 1892 7337 7323 4446 654 5254 
1 13 7054 1109 7026 7046 1114 7034 2911 7016 2756 7039 7038 1037 2051 
2 6 4842 7127 1548 7169 3981 7219 
2 9 3104 7048 5026 7077 2630 7128 2837 705 3815 
5 4 7184 5435 1106 7182 
4 7 7184 5432 7164 7150 7132 7114 7100 
3 13 7410 4209 7377 4634 2994 7319 2147 4326 1887 4839 2337 6402 7184 
3 12 7410 7415 4722 7417 7424 5145 1546 2861 7396 5037 4752 7380 
3 9 7222 7237 2624 4599 7287 2557 4398 4038 880 
3 11 2051 5118 3104 3795 305 4842 7102 1669 7101 3575 3442 
1 3 6985 1204 4778 
4 8 3811 961 6992 4881 7025 7036 4386 7045 
4 12 4889 3847 1726 7080 1832 5289 607 1759 4747 1268 7104 7114 
4 3 4889 262 7045 
2 3 7380 1789 2721 
1 3 3197 6900 673 
1 7 6900 3581 4272 871 1729 2323 6920 
5 2 3811 7478 
4 11 3811 1372 6929 3785 2031 2697 6889 6869 2063 3924 6809 
4 3 2063 6867 4049 
3 5 6742 3430 4321 2727 6809 
2 7 6809 4016 1478 5348 4126 194 3512 
1 11 4397 6342 2173 6295 6268 4676 1800 6178 1283 2686 1572 
1 11 1800 6173 314 120 3237 4910 5989 3510 3281 1102 2074 
1 10 1898 1865 4705 5992 3376 1603 6085 2601 4694 1572 
2 6 2074 4708 2106 4804 3642 3846 
2 5 2074 598 2641 4876 190 
1 6 4650 2344 3727 2010 5803 5778 
2 9 1898 3970 217 1450 4351 1412 4906 3464 3293 
2 5 3293 3365 1643 6045 6081 
2 5 3293 3850 384 5843 5868 
2 7 5868 3739 5822 5771 1188 4060 3018 
1 9 3018 5639 3708 4467 2269 1016 828 4859 5447 
1 11 5868 2985 3593 5933 513 395 3703 2858 3154 3561 4030 
1 8 6044 2282 2025 5159 6002 2631 3448 1643 
1 5 1296 5551 4973 739 5521 
2 24 252 3401 7754 5836 2492 5820 2145 5815 5825 3601 5855 1987 3664 2590 4759 5865 5867 5879 1905 5869 5884 3099 5897 5885 
1 4 5836 3054 5097 959 
5 13 4452 5658 1072 1864 2486 5616 5149 5622 4500 431 3950 5027 1946 
3 3 7804 5693 5658 
1 5 1946 3368 5662 2332 1732 
1 3 1732 5624 5627 
1 9 6262 6129 6267 5354 841 5096 432 1468 4614 
3 4 4614 80 6399 2279 
2 9 7219 3759 1911 761 1024 7321 2615 2679 844 
1 4 761 7316 2741 7332 
1 10 3442 7108 7096 7081 4750 735 3663 4945 673 3197 
3 9 3197 1461 5331 4778 5320 965 4749 7146 2051 
1 5 3302 3354 5166 3187 5417 
1 3 6795 6817 1773 
1 11 6809 867 2749 724 2453 6833 6812 6787 3395 6773 4234 
1 8 961 6942 6958 2113 829 3770 3638 1773 
1 6 829 5209 684 1179 2233 3338 
1 9 6809 4016 6828 5014 2847 4949 3488 6848 6863 
2 3 7184 6402 2550 
3 4 4326 2147 7266 3506 
3 3 3506 456 4946 
3 4 4946 3952 7267 4789 
3 9 7380 1858 7344 3830 2189 7254 1235 4084 7222 
2 4 7222 851 3570 1405 
1 4 1405 1881 4055 7067 
3 4 4789 1929 7279 7254 
1 6 7085 2088 7134 874 4954 60 
1 5 7658 2616 5153 4836 5156 
1 6 2262 254 5085 4149 3669 2183 
1 7 2262 6148 4306 1565 4831 3277 6073 
2 8 4354 5844 4615 5756 5689 208 5686 4150 
1 19 3585 5580 3528 1930 5552 5568 2060 4496 910 5540 4907 5565 5570 754 5583 5605 2295 5637 5658 
1 8 6795 2975 3595 3060 6720 6695 6664 3302 
1 4 4234 6771 2578 3595 
1 6 7747 7730 3928 7710 5010 7697 
1 3 6720 2719 3416 
1 5 6795 6803 5296 3501 6763 
1 8 1372 6908 4408 4172 2891 4780 6785 4234 
1 3 7036 7015 7028 
1 3 770 4782 6742 
1 3 5252 4355 4326 
1 5 7380 635 5321 5250 7436 
1 2 635 1541 
1 2 7237 887 
1 3 2624 7230 585 
1 3 7222 7213 2090 
1 2 1881 345 
2 4 4789 7257 562 554 
1 2 554 7185 
1 3 562 2229 7154 
1 4 4946 166 7244 554 
1 3 7415 7435 4722 
1 5 4634 3560 7320 2472 5252 
3 2 5435 3757 
1 4 3430 6766 6782 1478 
1 9 6262 2288 4391 3635 6064 6088 5951 3132 5836 
2 3 1669 507 4050 
2 5 7219 3927 3183 7268 7261 
1 2 1204 4537 
1 2 2837 1260 
1 4 1656 640 3496 366 
1 4 7332 7330 2768 652 
1 3 1476 1877 7448 
1 3 1877 4588 7493 
1 4 1476 287 7456 7474 
1 3 4509 1770 7389 
1 3 7008 2903 3238 
1 4 7231 1449 1247 1984 
2 5 3815 1656 1792 414 7273 
1 10 7273 4156 7289 1212 7256 1267 7238 1300 2795 7265 
2 2 3847 3653 
1 3 7396 3032 4462 
1 2 1892 4769 
1 2 2652 5254 
1 3 462 7322 7337 
1 3 7157 1116 2648 
1 4 7176 7189 1511 7201 
1 6 6081 2606 198 4730 6246 6277 
1 2 198 630 
1 2 3237 2656 
1 4 4676 1110 4827 3071 
1 4 434 825 306 5934 
1 3 3302 6626 5301 
1 3 6626 3546 2411 
2 3 285 5823 3229 
1 2 3229 1987 
1 2 285 5825 
1 4 285 1836 2283 4935 
1 9 5521 3821 5513 486 5467 3045 5058 2293 3289 
1 2 4354 5869 
1 3 4150 5643 3810 
1 4 1856 5646 2965 3446 
1 10 6344 6346 2515 4514 889 2830 4635 4143 5286 2201 
1 13 3786 6813 2437 4905 2300 6724 2038 2296 338 506 4330 2494 3667 
1 5 4965 309 6892 6911 3412 
1 11 4965 1771 1143 2696 6744 3310 4287 4605 302 2709 4688 
1 8 5156 2999 2637 3882 7572 743 2908 1543 
1 4 2908 7557 2638 1523 
1 4 7557 7562 2883 1122 
1 10 1543 7554 670 2351 342 3311 7545 7540 2873 2706 
2 9 461 1825 1971 5253 1064 7698 826 7704 3153 
1 4 7636 1256 2265 771 
1 3 771 496 4974 
1 9 4974 4518 7662 3078 7656 7661 3744 3502 7668 
1 5 4974 3462 7640 7635 1374 
1 18 1374 1626 7627 4571 7609 2207 2807 3881 7566 4923 3526 7531 5244 2885 4322 3040 3559 7466 
1 7 7466 3314 1438 7455 5087 7434 7420 
1 8 3928 1594 7727 3583 1970 674 3766 25 
1 4 7747 4944 7738 2920 
1 7 7697 105 4882 7682 5248 3857 7668 
1 2 7028 3653 
1 3 7114 4825 5261 
1 5 7436 4235 7470 967 2495 
1 4 880 1391 7395 577 
1 2 1391 4038 
1 5 2453 4870 1491 6882 4172 
1 7 6044 6040 3869 6070 6059 3978 6013 
1 3 4030 4847 5105 
1 3 5447 3490 693 
1 4 5447 2217 2570 1236 
1 6 5934 2954 5220 5805 2156 4331 
1 4 2656 2754 6036 4997 
1 7 5024 4921 5925 3563 5974 4295 4997 
1 9 5934 2605 4362 2689 6006 4244 4855 6017 4997 
1 3 209 1601 2412 
1 5 2412 1369 738 3334 5659 
1 4 5778 5758 2263 209 
2 8 190 4297 2805 495 360 1625 5705 209 
1 5 9 4271 4405 4897 1809 
1 9 1809 7516 3943 7508 5305 7543 494 7569 1122 
1 9 5156 441 2527 1424 7641 2796 1287 3691 1621 
1 8 2923 7585 7592 458 1418 7604 1286 1621 
1 8 1809 915 1724 5194 7553 4773 1767 7585 
1 8 461 4958 245 263 7652 7646 7654 7658 
1 8 245 4230 7616 7601 2310 2432 4356 342 
1 4 73 1189 6490 1746 
1 7 73 5052 2972 2 6475 1257 6446 
1 2 2 4056 
1 4 1257 6489 4157 148 
1 2 1987 5931 
1 8 5686 4551 2704 4807 3292 5755 2983 2604 
1 2 5885 5942 
2 7 1898 3398 5066 3290 4650 5896 3846 
1 7 2601 807 2211 6139 1763 4524 1171 
1 7 1171 6142 2669 6168 4528 6195 630 
1 9 3071 539 1377 1130 3226 1044 6503 6513 92 
1 11 6354 1341 6344 3345 6278 6259 504 3284 4888 2593 2262 
1 3 2262 6185 929 
1 6 5254 4653 7206 1577 7157 7168 
2 3 7176 7160 7168 
1 4 7168 4100 2724 7108 
1 6 7168 3969 7126 7107 7094 4633 
1 3 4633 4023 4757 
1 3 3289 902 5445 
1 12 1296 5276 2878 5532 1745 4915 5503 5488 4864 5480 4850 5445 
1 10 2156 5760 2747 5701 1649 1651 5599 3550 5589 5226 
1 7 3512 3833 6768 3241 6722 7 3632 
1 8 1720 6376 2573 1707 4728 6500 1896 6584 
1 10 6584 1944 4600 6609 906 2148 6649 6673 475 3632 
1 3 4590 465 252 
1 13 4590 5960 392 848 2955 1586 6156 3562 6206 344 6266 6287 6262 
1 3 2589 3558 6266 
1 3 2589 5969 5225 
1 4 5225 3073 2114 6202 
1 5 6202 2618 6171 6141 434 
1 5 6202 308 3015 644 4423 
1 6 6491 6439 241 6371 545 5225 
1 9 2573 4282 5062 2760 6393 1920 749 6343 545 
1 2 1707 3469 
1 4 1336 6583 1580 3072 
1 5 1336 919 1629 3225 1896 
1 6 2148 1048 156 2477 478 3234 
1 3 1336 3483 2477 
1 3 3241 2517 3438 
1 2 2517 4909 
1 5 6845 6827 6801 606 4293 
1 4 606 6752 3796 6711 
1 4 6694 2141 1241 2244 
1 13 6694 6643 1034 3723 952 6536 2671 5091 3343 6459 5205 416 1720 
1 5 2671 4392 2314 3548 1186 
1 5 2314 4406 6612 6640 187 
1 3 1186 1334 4600 
1 3 187 5323 6711 
1 2 1827 6832 
1 4 6784 3447 6718 6694 
1 3 2327 2355 3987 
1 2 3632 820 
1 4 820 4164 2526 6711 
1 5 2244 6704 1131 2085 4293 
1 8 6921 2311 920 277 3514 3163 6946 6955 
1 2 277 6962 
1 4 6946 2447 2728 4628 
1 3 4628 24 5377 
1 2 5377 6839 
1 8 4670 6910 1550 6966 3095 318 7013 4032 
1 6 7011 3189 3441 3196 6906 6878 
1 5 3441 6973 4947 5335 4032 
1 5 7011 3050 7069 466 4309 
1 2 3050 5380 
1 10 5018 7394 4913 7369 4103 1305 7306 1519 4028 3209 
1 4 4028 7262 2587 7360 
1 8 7360 4262 802 4548 5003 943 2877 5018 
1 6 7360 5382 7361 623 7370 7401 
1 2 5382 4822 
1 2 2161 3124 
1 4 6955 6939 40 1290 
1 4 3166 4348 2390 1780 
1 2 4348 7084 
1 6 3166 7092 1104 7091 1224 1290 
1 2 7013 1194 
1 5 1194 5356 1403 1749 1628 
1 2 1403 7136 
1 2 691 3709 
1 4 7401 1819 3276 7313 
1 2 298 7313 
1 3 1628 398 4021 
1 3 398 7109 7091 
1 7 7136 1840 2049 7235 3728 5263 7313 
1 3 3709 7224 7235 
1 2 7224 3124 
1 3 3276 1673 3124 
1 3 6141 2210 4083 
1 3 2327 3920 6821 
1 3 2327 927 5377 
1 4 6839 6847 4340 4670 
1 3 4670 6875 6845 
1 4 3013 5195 6858 6845 
1 4 3013 6861 2122 6906 
1 5 6491 6485 6479 1599 492 
1 4 492 2222 6514 1629 
1 2 4728 6499 
1 2 5365 6848 
1 4 6821 5365 3162 3512 
1 3 6784 1827 6835 
1 3 6832 979 843 
1 5 6835 6857 6878 6917 843 
1 4 3987 3010 971 820 
1 3 4628 1232 6863 
1 5 92 6548 3959 2934 1684 
1 9 1684 6645 3379 6589 6582 4440 4693 4976 6600 
1 4 4976 8 4820 1862 
1 6 1130 3341 1469 4058 6389 3070 
1 5 434 6111 4478 1251 449 
1 9 4688 4709 6516 3131 6487 3303 3261 6552 3667 
1 14 3667 6586 113 6550 1689 4197 6508 4791 611 6449 6426 3092 4638 1912 
1 10 4965 1608 4972 2864 3626 1810 6765 2745 3451 506 
1 9 9 7392 2084 4121 3263 4366 1600 7276 7243 
1 13 2074 5024 605 1250 966 3905 4812 3643 3259 2957 3011 4846 5220 
1 7 5220 4578 218 3911 274 3682 252 
1 9 3786 6797 3083 471 4184 3763 5283 4046 6739 
1 8 4924 6241 1392 4811 94 4544 2646 5372 
1 7 5372 189 6189 255 5193 785 627 
2 9 627 509 6027 6009 5986 5949 3069 712 5849 
1 6 5849 5957 5973 1417 5964 1041 
1 8 5809 5724 5835 4051 714 3417 1602 1041 
1 6 5658 3207 3167 5720 2067 5809 
1 9 5961 5918 3831 5860 2479 5042 4482 5883 5885 
2 7 1912 4112 6352 1963 3954 6285 6260 
2 10 6260 810 6229 480 2947 5176 6162 864 1822 2808 
2 16 950 6200 6151 6120 6094 6033 4344 6026 4835 6123 5985 1281 4338 5984 4428 5961 
1 7 1822 732 3824 6248 6286 1015 6355 
1 5 3824 6272 4805 5259 2065 
1 3 1912 1125 5259 
1 9 480 4109 6224 1129 4979 4489 523 2115 1912 
1 3 6355 1380 6417 
1 5 950 6265 762 5314 1380 
1 5 6417 1293 6443 6455 385 
1 3 4251 3404 6586 
1 10 595 5813 5175 1428 2016 784 3419 1727 7806 3106 
1 9 6222 4995 2490 3710 340 445 737 1477 1506 
1 10 1506 6058 4737 1798 46 5364 5948 3252 1089 3106 
1 12 2296 1875 6688 6680 1589 6606 6592 3536 6540 2117 319 221 
1 14 4688 4952 6560 3444 6495 4005 284 4499 6367 6348 4224 6293 2166 6222 
1 10 3106 9637 2676 5990 830 710 4798 570 1698 4811 
1 8 595 5817 5842 4679 5870 5856 5188 5061 
1 4 5061 4250 5976 6009 
2 7 5658 334 4439 4508 3393 248 125 
1 10 5521 1834 5515 5522 5506 4283 2415 2997 5131 4729 
1 4 2686 6228 1895 6231 
1 4 2686 5080 4089 4400 
1 4 125 2281 5739 4753 
1 5 125 4377 5721 5716 5699 
1 10 5699 5794 3878 5791 5059 5845 5838 2461 1258 5061 
1 8 595 4294 5298 1846 5694 2525 5638 5627 
1 10 627 6087 6051 6028 6001 2082 5912 2532 709 595 
1 8 4753 5774 4937 642 3429 5881 5909 1041 
1 4 125 995 2682 5622 
1 6 6073 6047 6024 5998 2387 5942 
1 6 2183 550 5174 1107 2190 5879 
